..........
.........T
.......WWW
..........
..........
..........
..........
..W.......
..W.......
S.W.......