......WW....
.TW.........
WWWWW.....WW
....W.......
............
WW...WWWWWWW
.....W......
....WW......
...WW....WWW
............
.W..........
.W...W.....S