TW........
..........
......WWWW
WW........
..WW......
..........
..........
..WW......
..W.......
S.W.......